ABBREVIATION	A short form of a word or phrase
ABDOMEN	The part below your chest
ABILITY	Skill to do something
ABOLITION	Officially end a system
ABSENCE	Not being present
ABUSE	The use in a wrong or rude way
ACADEMY	Related to the school society
ACCELERATOR	Pedal to go faster
ACCENT	Characteristic way to pronounce words
ACCEPTANCE	To say yes or agree to take
ACCESS	To get information on your computer
ACCESSIBILITY	Ability to get information
ACCESSORY	A item which can be added to body
ACCESSORIES	The items that can be added to body
ACCIDENT	Injury, damage, or death in traffic
ACCOMMODATION	Building or rooms where people live or stay
ACCOMPLISHMENT	Something great that you achieved
ACCORD	
ACCORDION	Stretchable musical instrument
ACCOUNT	Arrangement to get service from a bank or Web
ACCOUNTANT	A person to keep financial accouts
ACCOUNTS	Records of incomes or expenses
ACCURACY	Degree of correctness
ACHIEVEMENT	Something you succeeded after great efforts
ACID	Dangerous chemical; the opposite of alkali
ACKNOWLEDGMENTS	The names of all the people who helped the writer
ACQUAINTANCE	Someone who you met but you don't know well
ACRE	A unit for an area of land
ACRES	The units for an area of land
ACRYLICS	Artificial paints that quickly dry
ACT	A thing that someone does
ACTION	The thing of doing something to achieve an aim
ACTIVITY	Something you spend time doing
ACTOR	Someone who performs in drama or movie
ACTRESS	A woman who performs in drama or movie
AD	__vertisement
ADDICT	Someone who cannot stop doing
ADDICTION	Unable to stop taking alcohol, drugs, etc.
ADDRESS	The location of a website on the internet
ADHESIVE	A substance for attaching things together
ADJECTIVE	A word that describes a person or thing
ADMINISTRATION	The job of managing a business or an organization
ADMINISTRATOR	A person whose job is to manage the system
ADMIRATION	Strong feeling of liking and respect
ADMISSION	Permission or fee to enter a place
ADULT	A fully grown person
ADVANCE	A movement to go forward
ADVANTAGE	Something that makes you better than others
ADVENTURE	A unusual, exciting and dangerous experience
ADVERB	A word that adds information to the verb
ADVERT	Information on products, events, etc.
ADVERTISING	The business of creating info on products, events, etc.
ADVISOR	An expert whose job is to give suggestion
ANTENNA	A equipment to receive TV or radio signals
AEROBICS	Exercise to strengthen the heart and lungs
AIRPLANE	A fixed-wing vehicle that flies in the sky
AEROSOL	Fine solid or liquid particles in a gas
AFFAIR	A sexual relationship between two unmarried people
AFFAIRS	Important events and situations
AFFECTION	The strong feeling of loving or liking someone
AFTERNOON	Between lunchtime and about six o'clock
AGE	The number of years that you have lived
AGENCY	Business to provide service
AGENDA	A set of things that you want to do
AGENT	A person to do business for another person
AGONY	Severe pain
AGREEMENT	Accordance in opinion
AGRICULTURE	Taking care of crops and farm animals
AID	Giving money or something to help people
AIDS	A disease that destroys the immune system
AIM	The purpose or target of something
AIR	The gases around us
AIRCRAFT	A plane or helicopter
AIRLINE	A company that provides air transport
AIRPORT	A place where airplanes come and go
AISLE	A narrow passage between rows
ALARM	A warning notice of something
ALBUM	A collection of songs or pictures
ALCOHOL	Beer, wine, spirits, etc.
ALCOHOLIC	Someone who cannot stop drinking
ALGEBRA	A type of math that uses letters and signs
ALIEN	A creature from another planet
ALKALI	The opposit of an acid
ALLAH	The name of God in Islam
ALLERGY	The body's reaction to a particular substance
ALLEY	A narrow street between buildings
ALLIANCE	A group of people that work together
ALLIGATOR	A long animal with big mouth and short legs
ALLY	A country that supports another one in a war
ALMOND	A nut in a fruit shell
ALPHABET	A set of letters
ALTERNATIVE	Another thing to use instead
ALTITUDE	How high up from the sea?
ALUMINIUM	A useful light metal for making things
AM	A time between midnight and noon
AMATEUR	Someone not professional
AMAZEMENT	The feeling of surprising
AMBASSADOR	A diplomatic official of the highest rank
AMBITION	A strong desire to achieve something
AMBULANCE	A car to take people to the hospital
AMENDMENT	A change that is added to a law
AMOUNT	How much stuff is there?
AMPLIFIER	A device often used for electric guitars
AMUSEMENT	Experience of finding something funny
ANAESTHETIC	Substance that make you feel less pain
ANALYSIS	Thinking about the details of something
ANCESTOR	An early type of animal or plant
ANCHOR	A heavy object to stop the ship
ANGEL	Heavenly messenger from God
ANGER	Strong feelings against uncomfortable something
ANGLE	Units are degrees or radians
ANIMAL	A creature such as a dog or a cat
ANIME	Moving cartoons
ANIMATION	A method to show moving images
ANKLE	The joint of foot and leg
ANNIVERSARY	A memorable day after some years
ANNOUNCEMENT	It tells people something officially
ANNOUNCER	Who delivers the news on radio and TV?
ANOTHER	A different thing
ANSWER	A way to solve a problem
ANT	A small crawling insect
ANTENNA	A device to transmit/receive radio waves
ANTIBIOTIC	A drug to kill bacteria
ANTICIPATION	Excitement that something is coming
ANTIPERSPIRANT	A chemical that reduces sweating and perspiration
ANTIQUE	An object of a bygone era
ANTLER	The horn on the head of a male deer
ANTONYM	A word that means the opposite
ANUS	Asshole
ANXIETY	A nervous and warried feeling
ANY	I welcome ___thing from your side
ANYBODY	"Somebody" in a question sentence
ANYONE	"Someone" in a question sentence
ANYTHING	"Something" in a question sentence
APARTMENT	A flat; a suite of rooms forming one residence
APE	A type of animal like a monkey but tailless
APOLOGY	Something to tell someone that you are sorry
APOSTROPHE	A punctuation mark '
APP	A computer program
APPEARANCE	The way that it looks
APPENDIX	Extra information at the end of a book
APPETITE	A strong desire or liking for something
APPLAUSE	To clap your hands to praise
APPLE	A fruit or computer company
APPLIANCE	A machine to do a job in your home
APPLICANT	A person who makes an application for a job
APPLICATION	A computer program
APPOINTMENT	An arrangement to meet someone
APPRECIATION	A full understanding of a situation
APPRENTICE	A newcomer who works to learn their skill
APPROVAL	The decision of accepting something
APRICOT	A smaller type than peach
APRIL	The 4th month of the year
APRON	Protective clothing for cooking
AQUARIUM	A glass box filled with water to keep fish
ARCH	A structure that is curved at the top
ARCHAEOLOGY	The study of the ancient human past
ARCHAEOLOGIST	A person that investigates historic site
ARCHITECT	A person who designs buildings
ARCHITECTURE	The style of the design of a building
AREA	A particular part of a town or country
ARGUMENT	The act of reasoning or discussing
ARITHMETIC	Basic manipulation of numbers (adding, multiplying, etc.)
ARM	The part of body between shoulder and hand
ARMCHAIR	This supports your arms
ARMOUR	Soldiers put on this
ARMPIT	This part is under your arm
ARMS	Bombs, guns, etc.
ARMY	A large group to fight battles on land
ARRANGEMENT	A plan or preparation for a future event
ARREST	To take someone to a police station
ARRIVAL	The fact that someone have reached the destination
ARROW	A long thin weapon with sharp end
ART	Pictures or objects that are created to appreciate
ARTERY	The tube that carries blood from heart to the entire
ARTHRITIS	The condition that the joint is swell and becomes painful
ARTICHOKE	An immature flower bud of a thistle
ARTICLE	A piece of writing in a newspaper or magazine
ARTIST	A person who creates art, music, dance, etc.
ASH	The grey powder after burning
ASHTRAY	A small dish for cigarette ash
ASPARAGUS	This spring vegetable normally takes 3 years to harvest
ASPECT	A particular part or feature of something
ASPIRIN	A mild drug that reduces pain
ASSAULT	A physical attack on a person
ASSEMBLY	Putting parts together to make something
ASSESSMENT	Gathering and reviewing information to make a decision
ASSET	A useful or valuable thing or person
ASSIGNMENT	Assigning a task to someone
ASSISTANCE	The action of helping someone by sharing work
ASSISTANT	Someone who helps another person by sharing work
ASSOCIATE	A person who closely connected to another person
ASSOCIATION	An official group of people who has the same purpose
ASSORTMENT	A collection of various kinds of things
ASTERISK	The sign *
ASTHMA	A medical condition that affects the airways
ASTONISHMENT	A feeling of great surprise
ASTRONAUT	A person who travels beyond the Earth's atmosphere
ASTRONOMY	The scientific study in the universe
ASTRONOMER	A scientist who studies the universe
ATHLETE	A person who do a professional sport
ATLAS	A collection of maps
ATM	A banking machine that serves people
ATMOSPHERE	The mixture of gases that surrounds the planet
ATOM	The smallest unit of ordinary matter
ATTACHMENT	An additional file sent with an email message
ATTACK	An aggressive act against a person or place
ATTEMPT	The action of making an effort to achieve or complete
ATTENDANT	Someone whose job is to serve people in a place
ATTENTION	The action of taking special care of something or someone
ATTIC	A space or room inside the roof of a building
ATTRACTION	A feeling of interest in something or someone
AUBERGINE	A purple egg-shaped fruit
AUCTION	A sale of a good or property to the highest bidder
AUDIENCE	The group of spectators
AUDITION	A test to determine suitable performers
AUGUST	The eighth month of the year
AUNT	The sister of one's father or mother
AUTHOR	A writer of a book, article, or something
AUTHORITY	The legal right or ability to control
AUTOBIOGRAPHY	A self-written story of one's life
AUTOGRAPH	A person's own handwriting or signature
AUTUMN	The season between summer and winter
AVALANCHE	A rapid flow of massive snow down a slope
AVENUE	A broad road in a town or city
AVERAGE	A calculated central value of a set of numbers
AVOCADO	An alligator pear or butter fruit
AWARD	A prize, certificate, or medal for achievement
AXE	A tool used for chopping wood
AXIS	An imaginary line marking the middle
BABY	A very young child
BABYSITTER	A person who looks after a very young child
BACHELOR	A man who has never married
BACK	The rear surface of the human body
BACKBONE	The support of a system or organization
BACKGROUND	The scenery that is behind a main figure or object
BACKPACK	A big bag to carry things on your back
BACKSTROKE	A swimming style that lies on one's back
BACKUP	A copy of computer files in case of loss or damage
BACKYARD	The land at the rear side of a house
BACON	A salt-cured cut of pig's meat
BACTERIA	Very tiny organisms that can make people sick
BADGE	A token of membership in a society or group
BADMINTON	A game that uses a shuttlecock
BAG	A container for carrying things
BAGGAGE	Suitcases, trunks, and personal belongings
BAIT	A food or somehing, used in fishing, trapping, etc.
BAKER	A person who makes bread and cakes
BAKERY	An establishment that produces and sells flour-based food
BAKING	A method of preparing food that uses dry heat
BALANCE	A state where things are of equal weight or force
BALCONY	A platform projecting from the wall of a building
BALL	A object in the shape of a sphere
BALLET	A performance of dancing that tells a story
BALLOON	A small rubber bag which is inflated with air
BAMBOO	A type of grass with a hard, woody, hollow stem
BAN	An official or legal prohibition
BANANA	One of the most popular fruits worldwide
BAND	Most popular elongated edible fruit
BANDAGE	A strip of fabric used to cover wounds
BANDAID	A brand of adhesive bandages of J&J
BANISTER	A handrail with its supporting posts
BANJO	A musical instrument with drum-like body and strings
BANK	A financial institution
BANKRUPT	Unable to pay their debts
BANNER	A piece of cloth that shows some information
BAPTISM	Christian rite of admission using water
BAR	Where alcoholic drinks are served
BARBECUE	A cooking method for meat and other foods with fire
BBQ	Abbreviation for barbecue
BARBER	A person who cuts men's hair
BARGAIN	A sale in a lower price than its true value
BARK	The outermost layers of stem or root of wood
BARN	A large farm building
BARRACKS	A temporary building used for housing people
BARREL	The wine is brewed in this container
BARRICADE	A barrier to stop enemies or vehicles
BARCODE	A machine-readable black lines and spaces
BARRIER	A fence or something that prevents movement
BARTENDER	A person serving drinks at a bar
BASE	The bottom or lowest part of something
BASEBALL	A bat-and-ball sport
BASEMENT	It is the floor below ground level
BASIN	A depression in the Earth's surface
BASIS	The underlying support or foundation of something
BASKET	A container used to hold or carry things
BASKETBALL	A team sport on a rectangular court, that uses a ball
BASS	The low tone
BAT	A flyable mammal
BATCH	A set of jobs that can execute at one time
BATH	A container for water, used for washing the body
BATHROBE	A loose coat after having a shower
BATHROOM	A room containing a shower
BATHTUB	A container for holding water for bathing
BATON	A thin stick that is used by a music conductor
BATTER	A flour mixture with liquid and other ingredients
BATTERY	A source of electric power by chemical reaction
BATTLE	An occurrence of combat in warfare
BAY	An inlet of the sea or lake
BC	Abbreviation for Before Christ
BEACH	An expanse of sand or pebbles along a shore
BEAD	A small and decorative object that is pierced for threading
BEAK	A bird's horny projecting jaws
BEAM	A line of light coming from a source
BEAN	A edible seed, or the pod containing seeds
BEAR	A large and strong wild animal
BEARD	The hair that grows on a man's face
BEAST	A large and dangerous animal
BEAT	The basic unit of time in music
BEAUTY	A beautiful woman
BEAVER	An animal that make dams
BED	A piece of furniture for people to sleep and rest on
BEDROOM	A room for sleeping in
BEDSPREAD	A lightweight and decorative bed covering
BEDTIME	The usual time when someone goes to bed
BEE	A flying insect that can sting you
BEEF	Meat from cattle
BEEHIVE	Artificial place for bees to live
BEEP	A short, high-pitched sound
BEER	A bubbly alcoholic beverage made from malt
BEETLE	An insect with a hard and shiny black body
BEGGAR	A person who asks for money or food
BEGINNER	A person just starting to learn
BEGINNING	The point or time at which something starts
BEHALF	A person speaking or acting instead of another person
BEHAVIOUR	The way in which one conducts oneself
BEING	The material or immaterial existence of a thing
BELIEF	Trust, faith, or confidence in someone or something
BELL	A hollow metal device for producing sound
BELLY	The stomach or the part around the stomach
BELONGINGS	A person's movable possessions
BELT	A strip of leather or cloth around the waist
BENCH	A long seat for several people
BERRY	A small, pulpy, and often edible fruit
BEST	The most excellent and desirable one
BET	The action of gambling money on a race, game, etc.
BETTING	The action of gambling money on a race, game, etc.
BIBLE	The holy book
BICYCLE	A man-powered vehicle consisting of two wheels
BIKE	A bicycle or motorcycle
BIKINI	A two-piece swimming costume for women
BILL	A proposal for a new law
BILLBOARD	An American music and entertainment magazine
BILLIONAIRE	A person with assets of $1 billion or more
BIN	a container for waste or something
BINOCULARS	An optical instrument with a lens for each eye
BIOGRAPHY	A detailed description of a person's life
BIOLOGY	The scientific study on lives
BIRD	A creature with wings and feathers
BIRDHOUSE	A box placed in a tree
BIRTH	The emergence of a baby
BIRTHDAY	The anniversary of the day on which a person was born
BISCUIT	A small quick bread made from dough
BISHOP	One having spiritual or ecclesiastical supervision
BIT	The smallest unit of data in a computer
BITE	To use the teeth to cut into something
BLACK	The color of sky at midnight
BLACKBERRY	A smartphone made by the Canadian company
BLACKBOARD	A hard and dark surface used in a classroom
BLACKMAIL	An act of coercion using the threat
BLACKSMITH	A person who makes and repairs iron tools by hand
BLADDER	A hollow organ in the lower pelvis
BLADE	The flat, sharp edge of a knife or sword
BLAME	Responsibility for a fault or wrong
BLANKET	A large, thick cloth
BLAST	A big explosion like a bomb
BLAZE	A massive fire that destroys lots of things
BLAZER	A type of jacket as part of a uniform
BLEACH	A chemical to whiten clothes
BLEEDING	The loss of blood from the circulatory system
BLEND	A mixture of different substances or other things
BLIND	Something to hide the inside or keep the sun out
BLINDFOLD	A piece of cloth to cover someone's eyes
BLISTER	A small pocket of body fluid within the skin
BLIZZARD	A severe snow storm with gusty winds and obscured visibility
BLOB	A small amount of a thick liquid
BLOCK	A solid mass of wood, stone, etc.
BLOG	An online diary or journal located on a website
BLOGGER	A person that does blog
BLONDE	A woman with pale-colored hair
BLOOD	The red liquid that flows inside the body
BLOSSOM	The flowers that appear on a fruit tree
BLOW	A hard hit from someone's hand or from an object
BLUEBERRY	A small dark blue fruit
BLUES	A genre of the slow and sad music
BLUETOOTH	Wireless technology for communicating data between devices
BOARD	A flat and thin piece of wood
BOAT	A small ship
BODY	The whole physical structure of a person or an animal
BODYGUARD	A attendant whose duty is to protect a person
BOLT	A mechanical fastener with a threaded shaft
BOMB	An explosive weapon to kill people or destroy something
BOND	A loan taken out by a company
BONE	A part of the skeleton in the vertebrate animal
BONFIRE	A large open-air fire that is made outside
BONNET	The metal cover over the engine at the front
BONUS	An extra money that is added to someone's pay
BOOK	A set of pages of a written text with cover
BOOKCASE	An open cabinet to keep books
BOOKLET	A very thin book with a small number of pages
BOOKMARK	A mark placed between the pages
BOOKSHELF	An open cabinet to keep books
BOOKSHOP	A store where books are sold
BOOT	Italy is this shape
BORDER	A line separating two countries
BOSS	A person who exercises control or authority
BOTANY	The scientific study of plants
BOTH	One and the other; two together
BOTTLE	A glass or plastic container with a narrow neck
BOTTOM	The lowest point or part of something
BOUNDARY	A line which marks the limits of an area
BOUQUET	A bunch of flowers; nosegay
BOUTIQUE	A small shop selling clothes or accessories
BOW	A weapon of curved wood for shooting arrows
BOWELS	The lower parts of the digestive system
BOWLING	A game in which the player rolls a ball toward a pin
BOX	A container with flat sides of square or rectangle
BOXER	A person who fights in boxing
BOXING	A sport involving attack and defense with the fists
BOYFRIEND	A sweetheart who is a boy or man
BRA	A woman's undergarment to support the breasts
BRACELET	An article of jewellery that is worn around the wrist
BRACKETS	A pair of marks [ ]
BRAIN	A complex organ that controls thought, memory, etc.
BRAKE	A mechanical device for slowing or stopping a vehicle
BRANCH	A division or subdivision of the stem or axis
BRAND	The name or logo given to a product or service
BRANDY	A liquor produced by distilling wine
BRASS	An alloy of copper and zinc
BRAVERY	The brave spirit or conduct
BREAD	A food made mostly from flour and water
BREAK	A short holiday
BREAKDOWN	A mechanical failure
BREAKFAST	The first meal of the day, in the morning
BREAKTHROUGH	Overcoming something and having an achievement
BREAST	The tissue overlying the chest muscles
BREASTSTROKE	A swimming style with facing below
BREATH	The air taken into or expelled from the lung
BREEZE	A gentle wind
BRIBERY	Money, goods, or promise for corrupted purposes
BRICK	A rectangular block
BRIDE	A woman just married or about to be married
BRIDEGROOM	A man just married or about to be married
BRIDESMAID	A girl or woman who is an attendant of a bride
BRIDGE	A structure for crossing over the river
BRIEFCASE	A rectangular container for carrying documents
BRIEFS	A short, close-fitting underpants
BRIM	The projecting edge at the bottom of a hat
BRISTLE	The short, stiff, coarse hair
BROCCOLI	An edible green plant in the cabbage family
BROCHURE	An informative paper document that can be folded
BRONZE	An alloy of copper and tin
BROOCH	A piece of jewellery that is fastened to a cloth
BROOM	A long-handled brush, used for sweeping
BROTHER	Another man or boy with the same parents
BROW	The short hairs above each eye
BROWNIE	A small flat chocolate cake
BROWSER	Computer software for viewing the Internet
BRUSH	A tool for painting, cleaning, or grooming
BTW	A short form of "by the way"
BUBBLE	A ball of gas that appears in a liquid
BUCKET	A container to hold or carry liquids or solids
BUCKLE	A piece attached to one end of a belt
BUD	A small protrusion of a growing plant
BUDDHISM	A faith that was founded by Siddhartha Gautama
BUDDHIST	A person who believes in Buddhism
BUDGET	A spending plan based on income and expenses
BUFFALO	An animal that has two horns and lives near water
BUFFET	A self-service style of serving meals
BUG	An error, fault or flaw in computer program
BUGGY	A small vehicle, usually with no roof
BUILDER	A person who constructs something
BUILDING	A structure with a roof and walls
BULB	A stem that is the resting stage of a plant
BULK	The mass or size of something large
BULL	A male animal of the cow family
BULLDOG	A short dog with a large square head
BULLDOZER	A powerful machine for pushing earth or rocks
BULLET	A small, metal object that is shot from a gun
BULLY	A person who uses the offensive words or actions
BUMBLEBEE	A large, fuzzy insect with stubby wings
BUMP	The action of something hitting a hard surface
BUMPER	A device of the vehicle for absorbing shock
BUNCH	A group of the same kind of objects
BUNDLE	A package of things wrapped together
BUNGALOW	a small house, cottage, or cabin
BUNK	a built-in bed or a sleeping place
BUNNY	A child's word for a rabbit
BUOY	An anchored float serving as a navigation mark
BURDEN	A heavy load that you carry
BURGER	A food consisting of meat and vegetables on buns
BURGLAR	A person who illegally enters the building
BURGLARY	The unlawful entry into the building
BURIAL	The action of burying a dead body
TOOTHBRUSH	A tool for brushing teeth
HAIRBRUSH	A tool for combing hairs
BURQA	A clothing that covers face and body of a Muslim woman
BUS	A large automobile for carrying passengers
BUSH	A shrub or clump of shrubs
BUSINESSMAN	A man who works in commerce
BUSINESSWOMAN	A woman who works in commerce
BUTCHER	A person who slaughters animals and sells their meat
BUTTER	A soft yellow-to-white food made from cream
BUTTERFLY	A flying insects with large wings
BUTTERSCOTCH	A hard candy made with brown sugar and butter
BUTTON	A small hard object that you can push
BYTE	A unit of information, equivalent to 8 bits
CAB	A taxi
CABBAGE	A round vegetable of leaves
CABIN	A small wooden house
CABINET	A group of important members of the government
CABLE	A thick wire or rope
CACTUS	A plant with needles
CAFE	A place where you can buy drink or meals
CAFETERIA	A self-service restaurant in a school or somewhere
CAFFEINE	A chemical in coffee and tea
CAGE	A box-like enclosure for confining someone or something
CAKE	A sweet food made from flour, eggs, suger and butter
CALCULATION	The process of adding, subtracting, multiplying, dividing etc.
CALCULATOR	A small electoronic machine to get the numbers
CALENDAR	A list of days, weeks, and months
CALF	A young cow
CALL	The telephone can do this
CALLER	Someone who is making a call
CALORIE	A unit for measuring the amount of energy in food
CAMEL	An animal with one or two large lumps
CAMERA	A machine to take photographs or make films
CAMP	An aesthetic style and sensibility of bad taste and ironic
CAMPAIGN	A series of actions that are meant to achieve something
CAMPER	Someone who is staying in a tent
COMPFIRE	A fire in camping
COMPOSITE	A material made from two or more different materials
CORONA
CAMPUS	The grounds and buildings of a university or college
CAN	A metal container for food, drink or paint
CANAL	A long narrow river made by people to travel along
CANCER	A serious disease that cells become uncontrollable
CANDIDATE	A person who applies for a job or is nominated for election
CANDLE	A long stick of wax
CANDLESTICK	A stick that keeps a light
CANDY	A confection that features sugar as a principal ingredient
CANE	A long hollow stem of bamboo
CANNON	A large heavy gun that is used in the past
CANOE	A small narrow boat
CANTEEN	a store that sells food and drink at an institution
CANVAS	A piece of material to paint on
CANYON	A long narrow valley with steep sides
CAP	An attachable hat on the top
CAPACITY	The maximum amount that someone can do
CAPE	A very large piece of land sticking out into the sea
CAPITAL	The primary city or town that has the government's offices
CAPITALISM	The economic system by private companies
CAPITALIST	A person who has capital especially invested in business
CAPTAIN	An officer of middle rank in the army or navy
CAPTION	A title or brief explanation
CAPTIVE	A person or animal who is kept in a place
CAPTIVITY	The condition of being imprisoned or confined
CAR	A motor vehicle
CARAMEL	A sweet food made from burnt suger, butter and milk
CARAVAN	A group of people or animals traveling together
CARBOHYDRATE	A substance in food that provides energy to our body
CARD	A rectangular piece of hard paper or plastic
CARDBOARD	A paper-based material that is thicker than the standard paper
CARDIGAN	A collarless sweater or jacket with open front
CARE	To have concern or responsibility for someone or something
CAREER	The part of life that is concerned with employment
CARETAKER	A person employed to look after a building
CARGO	Goods carried on a ship, aircraft, or vehicle
CARNATION	A fragrant flower in white, pink or red
CARNIVAL	A big festival of parades, street parties etc.
CARNIVORE	An animal that feeds on other animals
CAROL	A religious folk song or popular hymn
CARPENTER	Someone who makes and repairs wooden objects and structures
CARPET	A rug made of woven fibers
CARRIAGE	A large horse-drawn vehicle
CARROT	A healthy root vegetable; orange in color
CART	A strong open vehicle with two or four wheels
CARTON	A box or container usually made of cardboard for liquid
CARTOON	A type of illustration that is drawn by hands
CASE	An instance of a disease, injury, or problem
CASH	Money in coins or notes
CASHEW	A kidney-shaped seed, sourced from the tree
CASHIER	A person who handles the cash register
CASINO	A building or room for gambling games
CAST	The actors in a film, play, or show
CASTLE	A large strong building, built in the past by a ruler
CASUALTY	A person killed or injured in a war or accident
CAT	A cute animal with a long flexible tail
CATALOGUE	A complete list of product items
CATASTROPHE	A sudden and widespread disaster
CATEGORY	A class or division of people or things
CATERPILLAR	A larva of a butterfly or moth
CATHEDRAL	The principal church of a diocese
CATHOLIC	A person who belongs to the universal Christian church
CATTLE	A group of animals, including cattle, buffalo, bison, etc.
CAULIFLOWER	A cruciferous and nutritious vegetable
CAUSE	Something that gives rise to an action or phenomenon
CAUTION	A warning against danger or evil
CAVE	A large hole in the ground
CAVEMAN	A prehistoric man who lived in caves
CC	The abbreviation for "carbon copy"
CD	Compact Disc
CEILING	The upper interior surface of a room
CALEBRATION	A comparison between a known measurement and the measurement
CALEBRITY	A famous person, especially in entertainment or sport
CELERY	A low-calorie vegetable with a high water content
CELL	The basic building blocks of all living things
CELLAR	A room below ground level in a house
CELLO	A bass musical instrument of the violin group
CELSIUS	ÅãC
CEMENT	The basic ingredient of concrete
CEMETERY	A place of ground in which dead bodies are buried
CENSUS	An official count or survey
CENT	One hundredth
CENTILITRE	A metric unit of capacity, equal to one hundredth of a litre
CENTIMETRE	A metric unit of length, equal to one hundredth of a metre
CENTER	The middle point or part
CENTURY	A period of one hundred years
CERAMICS	An article made from clay hardened by heat
CEREAL	A grain used for food
CEREMONY	A formal religious or public occasion
CERTAINTY	The degree of being sure
CERTIFICATE	An official document attesting a fact
CHAIN	A series of linked metal rings
CHAIR	A seat for one person that has a back and legs
CHAIRMAN	A man chosen to preside over a meeting
CHAIRPERSON	The presiding officer of an organized group
CHAIRWOMAN	A woman chosen to preside over a meeting
CHALK	A variety of limestone mainly made of calcium carbonate
CHALLENGE	The attempt to do something difficult
CHAMPAGNE	A type of sparkling white wine from France
CHAMPION	A winner of first prize or first place in competition
CHAMPIONSHIP	A high-level competition to decide who is the best
CHANCE	A possibility of something happening
CHANGE	The transition of something into a different state
CHANNEL	A band of frequencies used in radio and TV
CHANT	The iterative speaking or singing of words
CHAOS	Perfect disorder and confusion
CHAPEL	A place of worship that has no pastor or priest
CHAPTER	A main division of a book
CHARACTER	A mark, sign, or symbol used in writing or printing
CHARACTERISTIC	A quality or treat that is typical of someone or something
CHARCOAL	A lightweight black carbon residue
CHARGE	The amount of electricity that a particle or object carries
CHARITY	The act of giving money, food, or other help to people
CHARM	A power of attracting, as personality or beauty
CHART	A graphical representation for data visualization
CHAT	An informal conversation
CHARTER	A formal document describing the authority or rights of people
CHAUFFEUR	A person employed to drive a motor vehicle
CHEAT	The act of deceiving
CHECKIN	The first procedure when arriving at an airport
CHECKUP	An examination of someone's or something's condition
CHEEK	Either side of the face below the eye
CHEER	A shout of praise or encouragement
CHEERLEADER	Someone who calls for and directs organized cheering
CHEESE	Nutritious food made mostly from milk
CHEF	A chief cook in a restaurant or hotel
CHEMICAL	The substance produced by chemistry
CHEMIST	A scientist trained in the study of chemistry
CHEMISTRY	The scientific study of the properties and behavior of matter
CHERRY	A small, soft, round, red fruit.
CHESS	A board game played between two players using pieces
CHEST	The part of the body between your neck and your abdomen
CHICK	A baby bird
CHICKEN	A bird raised by people for its eggs and meat
CHIEF	A leader or ruler of a people or clan
CHILD	A young person under the age of 18
CHILDREN	Young people under the age of 18
CHILDHOOD	The period of being a young person
CHILLI
CHIMNEY
CHIMPANZEE
CHIN
CHINA
CHIP
CHOCOLATE
CHOICE
CHOIR
CHOLESTEROL
CHOPSTICKS
CHORD
CHORE
CHORUS
CHRISTENING
CHRISTIAN
CHRISTIANITY
CHRISTMAS
CHROMOSOME
CHUNK
CHURCH
CIDER
CIGAR
CIGARETTE
CINEMA
CINNAMON
CIRCLE
CIRCUIT
CIRCULATION
CIRCUMFERENCE
CIRCUMSTANCE
CIRCUS
CITIZEN
CITY
CIVIL
CIVILIAN
CIVILIZATION
CHAIM
CLAM	A type of shellfish
CLAMP
CLAP
CLARINET
CLARITY
CLASH
CLASP
CLASS
CLASSIC
CLASSMATE
CLASSROOM
CLAUSE
CLAW
CLAY
CLEANER
CLERK
CLIENT
CLIFF
CLIMATE
CLIMAX
CLIMBER
CLIMBING
CLINIC
CLIP
CLOAKROOM
CLOCK
CLOSET
CLOTH
CLOTHES
CLOTHING
CLOUD
CLOWN
CLUB
CLUE
CLUSTER
CLUTCH
CLUTTER
CM
COACH
COAL
COAST
COASTLINE
COAT
COBWEB
COCKPIT
COCKROACH
COCOA
COCONUT
COCOON
COD
CODE
COFFEE
COFFIN
COIL
COIN
COINCIDENCE
COLD
COLESLAW
COLLAGE
COLLAR
COLLARBONE
COLLEGUE	A person someone works with
COLLECTION
COLLECTOR
COLLEGE
COLLIE
COLLISION
COLON	A mark :
COLONY
COLOR
COLUMN
COMA
COMB
COMBAT
COMBINATION
COMEDIAN
COMEDY
COMET
COMFORT
COMIC
COMMA	A punctuation mark ,
COMMAND
COMMENCE
COMMENT
COMMERCE
COMMITMENT
COMMITTEE
COMMUNICATION
COMMUNISM
COMMUNIST
COMMUNITY
COMPANION
COMPANY
COMPARATIVE
COMPARISON
COMPARTMENT
COMPASS
COMPETENCE
COMPETITION
COMPETITOR
COMPLAINT
COMPLEX
COMPLEXION
COMPLICATION
COMPOSER
COMPOSITION
COMPOUND
COMPREHENSION
COMPROMISE
COMPUTER
COMPUTING
CONCENTRATION
CONCEPT
CONCERT
CONCLUSION
CONCRETE
CONDITION
CONDITIONAL
CONDUCT
CONDUCTOR
CONE
CONFERENCE
CONFESSION
CONFIDENCE
CONFLICT
CONFUSION
CONGRATULATIONS
CONJUNCTION
CONNECTION
CONSCIENCE
CONSEQUENCE
CONSERVATION
CONSIDERATION
CONSISTENCY
CONSOLE
CONSONANT
CONSTITUENCY
CONSTITUTION
CONSTRUCTION
CONSULTANT
CONSUMER
CONTACT
CONTAINER
CONTEMPORARY
CONTENTS
CONTEST
CONTEXT
CONTINENT
CONTINUATION
CONTRACT
CONTRACTION
CONTRAST
CONTRIBUTOR
CONTRIBUTION
CONTROL
CONTROVERSY
CONVENIENCE
CONVERSATION
COOK
COOKBOOK
COOKER
COOKIE
COOKING
COOPERATION
COODINATION
COP
COPE
COPPER
COPY
CORAL
CORD
CORE
CORK
CORKSCREW
CORN
CORNER
CORNFLAKES
CORPORATION	A large business or company
CORPSE
CORRECTION
CORRESPONDENCE
CORRESPONDENT
CORRIDOR
COSMETICS
COST
COSTUME
COTTAGE
COTTON
COUCH
COUGH
COUNCIL
COUNT
COUNTER
COUNTRY
COUNTRYSIDE
COUNTY
COUPLE
COUPON
COURAGE
COURSE
COURT
COURTESY
COURTYARD
COUSIN
COVER
COW
COWARD	Someone who has no courage
COWBOY
CRAB
CRACK
CRACKER
CRADLE
CRAFT
CRAMP
CRASH
CRATE
CRATER
CRAWL
CRAYON
CREAM
CREASE	
CREATOR	Someone who has made something
CREATION	An act of producing or causing to exist
CREATURE	An animal, as distinct from a human being
CREDIT	The ability to borrow money or access goods or services
CRESCENT	A curved shape like the moon during its first and last quarters
CREW	A group of people who work closely together
CRICKET	A bat-and-ball game played between two teams of 11 players
CRIME	An act against the law
CRIMINAL	Someone who has committed a crime
CRISIS	A time of intense difficulty or danger
CRISP	A firm, dry, and brittle food
CRITIC	A person who judges, evaluates, or criticizes
CRITICISM	The expression of disapproval of someone or something
CROCODILE	A thick-skinned, long-bodied, fierce animal
CROP	A plant or animal product that can be harvested
CROSS	A figure of two intersecting lines or bars
CROSSROADS	A place of intersection of two or more roads
CROSSWORD	This puzzle you're playing
CROW	A black bird that najes a loud noise
CROWD	A large number of people gathered together
CROWN	A decorative object on the head of a king or queen
CRUISE	A voyage on a ship or boat
CRUMB	A small fragment of bread, cake, or biscuit
CRUST	The outermost shell of a terrestrial planet
CRUTCH	A long stick to help someone walk
CRY	An expression of distress, pain, or sorrow
CRYSTAL	A solid material whose constituents are arranged in a highly ordered structure
CUB	A young carnivorous mammal
CUBE	A solid object with six square surfaces
CUCUMBER	A long, green-skinned fruit with watery flesh
CUE	A signal to a performer
CUFF	Something encircling the wrist
CULTURE	The characteristics of a particular group of people
CUP	A container with a handle, used for drinking coffee, tea, etc.
CUPBOARD
CURIOSITY	A strong desire to know or learn something
CURL	A piece of hair having a curving shape
CURRENCY	A system of money for exchanging goods and services
CURRENT	A flow of electricity
CURRICULUM	The lessons and academic content
CURRY
CURSE	A rude or offensive word or phrase
CURSOR	The position indicator on a computer display screen
CURTAIN	A piece of cloth that hangs down from above
CURVE	A smooth, rounded line, shape, etc.
CUSHION	A bag that is filled with soft material
CUSTOM	A tradition or a usual way to behave
CUSTOMS	An authority or agency to regulate flow of goods
CUTLERY	Knives, forks, and spoons
CYBERSPACE	The virtual computer world
CYCLE	A complete sequence of events that repeats
CYCLIST	A person who rides a bicycle
CYLINDER	A tube in which a piston of an engine moves
CYMBAL	A percussion instrument of two round plates
DAD	A father
DADDY	A father (used by young children)
DAFFODIL
DAISY
DAM
DAMAGE
DANCE
DANCER
DANDELION
DANGER
DARK
DARLING
DART
DARTS
DASH
DASHBOARD
DATA
DATABASE
DATE
DAUGHTER
DAWN
DAY
DAYDREAM
DAYLIGHT
DAYTIME
DEADLINE
DEAL
DEATH
DEBATE
DEBRIS
DEBT
DECADE	A perios of ten years
DECEMBER	The last month of the year
DECEPTION
DECIMAL
DECISION
DECK
DECLARATION
DECORATION
DECREASE
DEED
DEER
DEFEAT
DEFENCE
DEFENDER
DEFICIT
DEFINITION
DEGREE
DELAY
DELEGATE
DELICATESSEN
DELIGHT
DELIVERY
DEMAND
DEMOCRACY
DEMOCRAT
DEMONSTRATION
DEN
DENIAL
DENIM
DENSITY
DENTIST
DEODORANT
DEPARTMENT
DEPARTURE
DEPOSIT
DEPOT
DEPRESSION
DEPTH
DEPUTY
DESCRIPTION
DESERT
DESIGN
DESIGNER
DESIRE
DESK
DESKTOP
DESPAIR
DESPERATION
DESSERT
DESTINY
DETAIL
DETAILS
DETECTIVE
DETERGENT
DETERMINATION
DEVASTATION
DEVELOPMENT
DEVICE
DEVIL
DEW
DIAGNOSIS
DIAGRAM
DIAL
DIALECT
DIALOGUE
DIAMETER
DIAMOND
DIAPER
DIARRHOEA
DIARY
DICE
DICTATION
DICTIONARY
DIESEL
DIET
DIFFERENCE
DIFFICULTY
DIGIT
DIGNITY
DILEMMA
DIMENSIONS
DINNER
DINNERTIME
DINOSAUR
DIP
DIPLOMA
DIPLOMACY
DIPLOMAT
DIRECTION
DIRECTOR
DIRECTORY
DIRT
DISABILITY
DISADVANTAGE
DISAGREEMENT
DISAPPEARANCE
DISAPPOINTMENT
DISAPPROVAL
DISASTER
DISBELIEF
DISC
DISCIPLINE
DISCO
DISCOMFORT
DISCOUNT
DISCOVERY
DISCRIMINATION
DISCUSSION
DISEASE
DISGRACE
DISGUISE
DISGUST
DISH
DISHONESTY
DISHWASHER
DISK
DISMAY
DISPENSER
DISPLAY
DISPOSAL
DISPUTE
DISRUPTION
DISSECTION
DISTANCE
DISTINCTION
DISTRACTION
DISTRESS
DISTRIBUTION
DISTRICT
DISTUBANCE
DITCH
DIVING
DIVER
DIVERSION
DEVISION
DIVORCE	The legal ending of marriage
DIY
DJ	Disc jockey
DOCK
DOCTOR
DOCUMENT
DOG
DOLL
DOLLAR
DOLPHIN
DOMAIN
DOME
DOMINOES
DONATION
DONKEY
DONOR
DOOR
DOORBELL
DOORKNOB
DOORSTEP
DOORWAY
DORMITORY
DOSE
DOT
DOUBT
DOUGH
DOUGHNUT
DOVE
DOWNPOUR
DOZEN	Twelve
DR	Doctor
DRAFT
DRAGON
DRAGONFLY
DRAIN
DRAMA
DRAMATIST
DRAUGHT
DRAWING
DRAW
DRAWBACK
DRAWER
DREAM
DRESS
DRESSER
DRILL	A tool for making a hole
DRINK
DRIVE	A trip in a car
DRIVER	A person who drives a vehicle
DRIVEWAY
DROP	A tiny amount of liquid, shaped like a ball
DROUGHT
DRUG	A chemical that is used as a medicine
DRUM
DRYER
DUCK
DUET
DUMMY
DUMP
DUNE
DUO
DUSK
DUST
DUSTBIN
DUSTER
DUSTMAN
DUTY
DUVET
DVD	Digital video disk
DWARF
EAGLE
EAR
EARACHE
EARDRUM
EARPHONES
EARRING
EARTH	The planet that we live on
EARTHQUAKE	A sudden massive movement of the Earth
EASE
EASEL
EAST
EASTER
EBOOK
ECHO
ECLIPSE
ECOLOGY
ECONOMICS
ECONOMIST
ECONOMY
ECOSYSTEM
EDGE
EDITION
EDUCATION
EFFECT
EFFORT
EGG
EGGPLANT
EIGHT	The number 8
EIGHTEEN	The number 18
EIGHTY	The number 80
EITHER
ELASTIC
ELBOW
ELECTION
ELECTRICIAN
ELECTRICITY
ELECTRONIC
ELEMENT
ELEPHANT	A huge gray animal with a long nose
ELEVATOR
ELEVEN	The number 11
ELF
EMAIL
EMBARRASSMENT
EMBROIDERY
EMBRYO
EMERALD	A bright green stone jewelley
EMERGENCY
EMOJI
EMOTION
EMPEROR
EMPHASIS
EMPIRE
EMPLOYEE
EMPLOYER
EMPLOYMENT
ENCOURAGEMENT
ENCYCLOPEDIA
END
ENDING
ENDURANCE
ENEMY
ENERGY
ENGAGEMENT	A promise to get married to someone
ENGINE
ENGINEER
ENGINEERING
ENGLISH
ENJOYMENT
ENQUIRY
ENTERPRISE
ENTERTAINER
ENTERTAINMENT
ENTHUSIASM
ENTRANCE
ENTRY
ENVELOPE
ENVIRONMENT
EPIC
EPIDEMIC
EPILOGUE
EPISODE
EQUAL
EQUALITY
EQUATION
EQUATOR
EQUIPMENT
ERA
ERASER
EROSION
ERRAND
ERROR
ERUPTION
ESCALATOR
ESCAPE
ESSAY
ESTABLISHMENT
ESTATE
ESTUARY
ETC
ETCETERA
EURO
EUROPEAN
EVALUATION
EVE
EVENING
EVENT
EVERYBODY
EVERYDAY
EVERYONE
EVERYTHING
EVERYWHERE
EVIDENCE
EVIDENT
EVIL
EVOLUTION
EXAGGERATION
EXAM
EXAMINATION
EXAMPLE
EXCELLENCE
EXCEPTION
EXCHANGE
EXCITEMENT
EXCLAMATION
EXCUSE
EXECUTIVE
EXERCISE
EXHAUSTION
EXHAUST
EXHIBITION
EXISTENCE
EXIT
EXPECTATION
EXPENSE
EXPERIENCE
EXPERIMENT
EXPERT
EXPERTISE
EXPLANATION
EXPLOSION
EXPLOSIVE
EXPORT
EXPRESSION
EXTENSION
EXTENT
EXTERIOR
EXTINCTION
EYE
EYEBALL
EYEBROW
EYEGLASSES
EYELASH
EYELID
EYESIGHT
FABLE
FABRIC
FACE
FACILITIES
FACT
FACTOR
FACTORY
FAILURE
FAIR
FAIRY
FAITH
FAKE
FALL
FAME
FAMILY
FAMINE
FAN
FANATIC
FANTASY
FAQ
FARE
FAREWELL
FARM
FARMER
FARMHOUSE
FARMING
FASHION
FAT
FATALITY
FATE
FATHER	Your male parent
FATIGUE
FAUCET
FAULT
FAVOUR
FAX
FEAR
FEAST
FEAT
FEATHER
FEATURE
FEBRUARY	The 2nd month of the year
FEE
FEEDBACK
FEELING
FEET
FELT	A type of soft thick cloth
FEMALE
FAMINISM
FEMINIST
FENCE
FERN
FERRY
FERTILITY
FEST
FESTIVAL
FEVER
FIANCE	The man that a woman is going to marry
FIANCEE	The woman that a man is going to marry
FIBRE
FICTION
FIELD
FIELDER
FIFTEEN	The number 15
FIFTY	The number 50
FIG
FIGHTER
FIGURE
FILE
FILENAME
FILLING
FILM
FILTER
FIN
FINAL
FINALIST
FINANCE
FINE
FINGER
FINGERNAIL
FINGERPRINT
FINGERTIP
FINISH
FIRE
FIREARM
FIREFIGHTER
FIREMAN
FIREPLACE
FIREWORK
FIRM
FISH
FIHSERMAN
FISHING
FIST
FIT
FIVE	The number 5
FLAG
FLAKE
FLAME
FLAP
FLASH
FLAT
FLAVOUR
FLAW
FLEA
FLEECE
FLEET
FLESH
FLEXIBILITY
FLICK
FLICKER
FLIGHT
FLIPPER
FLIRT
FLOAT
FLOCK
FLOOD
FLOODLIGHT
FLOOR
FLORIST
FLOUR
FLOW
FLOWER
FLU
FLUID
FLUTE
FLY	A small quick insect with two wings
FLYER
FOAM
FOCUS
FOETUS
FOG
FOIL
FOLD
FOLDER
FOLK
FOLLOWER
FONT
FOOD
FOOL
FOOT
FOOTBALL
FOOTBALLER
FOOTPATH
FOOTPRINT
FOOTSTEP
FORCE
FORECAST
FOREGROUND
FOREHEAD
FOREIGNER
FORESEE
FOREST
FOREWORD
FORGER
FORGERY
FORK
FORM
FORMAT
FORMATION
FORMER
FORMULA
FORT
FORTNIGHT	A period of two weeks
FORTRESS
FORTUNE
FORTY	The number 40
FOSSIL
FOUL
FOUNDATION
FAOUTAIN
FOUR	The number 4
FOURTEEN	The number 14
FOWL
FOX
FRACTION
FRACTURE
FRAGMENT
FRAME
FRAMEWORK
FRAUD
FREAK
FRECKLE
FREEDOM
FREEZING
FREEZER
FREIGHT
FREQUENCY
FRIDAY	The day between Thursday and Saturday
FRIDGE
FRIEND
FRIENDSHIP
FRIES
FRIGHT
FRILL
FRINGE
FROG
FRONT
FRONTIER
FROST
FROWN
FRUIT
FRUSTRATION
FUEL
FULLSTOP
FULLTIME
FUN
FUNCTION
FUND
FUNDING
FUNERAL
FUNGUS
FUNNEL
FUR
FURNACE
FURNITURE
FURY
FUSE
FUSS
FUTURE
GADGET	A small machine or useful object
GALAXY	A huge group of stars and planets
GALE	A very strong wind
GALLERY
GALLON
GAMBLE
GAMBLING
GAME
GANG
GAP
GARAGE
GARBAGE
GARDEN
GARDENER
GARMENT
GAS
GASOLINE
GATE
GATHERING
GAUGE
GEAR
GEESE
GEL
GEM
GENDER
GENE
GENERAL
GENERATION
GENERATOR
GENEROSITY
GENETICS
GENIUS
GENTLEMAN
GENTS
GENUINE
GENUS
GEOGRAPHY
GEOLOGY	The study of the Earth's structure and origins
GEOMETRY
GERM
GESTURE
GHETTO
GHOST
GIANT
GIFT
GIGABYTE	1024 megabytes
GINGER
GIRAFFE
GIRL
GIRLFRIEND
GLACIER
GLARE
GLASS
GLIMMER
GLIMPSE
GLOBALIZATION
GLOBE
GLORY
GLOSSARY
GLOVE
GLOW
GLUE
GM
GOAL
GOALKEEPER
GOALPOST
GOAT
GOD
GODDESS	A female god
GOGGLES
GOLD	A heavy valuable yellow-colored metal
GOLDFISH
GOLF
GOLFER
GOOD
GOODBYE
GOODNESS
GOODS
GOOGLE
GOOSE
GORGEOUS
GORILLA
GOSSIP
GOVERNMENT
GOWN
GP
GRADE
GRADUATE
GRADUATION
GRAFFITI
GRAIN
GRAM	A unit of weight
GRAMMAR
GRAN
GRAND
GRANDAD
GRANDCHILD
GRANDDAUGHTER
GRANDFATHER
GRANDMA
GRANDMOTHER
GRANDPA
GRANDPARENT
GRANDSON
GRANNY
GRANT
GRAPE
GRAPEFRUIT
GRAPH
GRAPHICS
GRASP
GRASS
GRASSHOPPER
GRATITUDE
GRAVE
GRAVEYARD
GRAVITY
GRAVY
GREASE
GREATNESS
GREED
GREEN
GREENHOUSE
GREETING
GRID
GRIEF
GRILL
GROCERIES
GROOM
GROOVE
GROUND
GUIDANCE
GUIDE
GUIDEBOOK
GUILT
GUITAR
GUITARIST
GULF
GUM
GUN
GUNMAN
GUST
GUTTER
GUY	A man
GYM
GYMNASTICS
HABIT
HABITAT
HAIL
HAIR
HAIRCUT
HAIRDRESSER
HAIRDRYER
HAIRSTYLE
HALF
HALVES
HALFTIME
HALFWAY
HALL
HALLOWEEN
HALLWAY
HALT
HAM
HAMBURGER
HAMMER
HAMSTER
HAND
HANDBAG
HANDBOOK
HANDCUFFS
HANDFUL
HANDKERCHIEF
HANDLE
HANDOUT
HANDSHAKE
HANDWRITING
HAPPINESS
HARBOUR
HARDWARE
HARM
HARMONY
HARP
HARVEST
HASTE
HAT
HAWK
HAY
HAZARD
HE
HEAD
HEADACHE
HEADING
HEADLIGHT
HEADLINE
HEADPHONES
HEADQUARTERS
HEALTH
HEAP
HEARING
HEART
HEARTBEAT
HEAT
HEATER
HEATING
HEAVEN
HEDGE
HEDGEHOG
HEEL
HEIGHT
HEIR
HELICOPTER
HELL
HELP
HEMISPHERE
HERB
HERBIVORE
HERD
HERO
HEROIN
HEROINE
HERS
HERSELF
HEXAGON	A shape with six straight sides
HIBERNATION
HICCUP
HIGHLIGHT
HIJAB
HIKE
HILL
HILLSIDE
HIM
HIMSELF
HINDU
HINDUISM
HINGE
HINT
HIP
HIPHOP
HIPPO
HIPPOPOTAMUS
HISTORY
HIT
HITCHHIKER
HIV
HIVE
HOAX
HOB
HOBBY
HOCKEY
HOLD
HOLE
HOLIDAY
HOLLY
HOLOCAUST
HOME
HOMEPAGE
HOMEWORK
HONESTY
HONEY
HONEYMOON
HONOUR
HOOD
HOODIE
HOOF
HOOK
HOOP
HOOVES
HOP
HOPE
HORIZON
HORMONE
HORN
HOROSCOPE
HORROR
HORSE
HORSESHOE
HOSE
HOSPITAL
HOST
HOSTAGE
HOSTESS
HOTDOG
HOTEL
HOUR
HOUSE
HOUSEHOLD
HOUSEWIFE
HOUSEWORK
HTML	Hypertext markup language
HUB
HUMAN
HUMANITY
HUMIDITY
HUMOUR
HUMP	A small raised area
HUNDRED	The number 100
HUNGER
HUNT
HUNTER
HURDLE
HURRICANE
HURRY
HUSBAND
HUSH
HUT
HYGIENE
HYMN
HYPERLINK
HYPHEN
HYPNOSIS
ICE
ICEBERG
ICESKATE
ICESKATING
ICICLE
ICING
ICON
ID
IDEA
IDEAL
IDENTIFICATION
IDENTITY
IDIOM
IDIOT
IDOL
IGNORANCE
ILLNESS
ILLUSION
ILLUSTRATION
IM	Instant messaging
IMAGE
IMAGINATION
IMITATION
IMMIGRANT
IMMIGRATION
IMPACT
IMPATIENCE
IMPERATIVE
IMPERIALISM
IMPORT
IMPORTANCE
IMPRESSION
IMPROVEMENT
IMPULSE
INABILITY
INBOX
INCENTIVE
INCH
INCIDENT
INCOME
INCREASE
INDEPENDENCE
INDEX
INDICATION
INDICATOR
INDIGESTION
INDIVIDUAL
INDUSTRY
INEQUALITY
INFANT
INFECTION
INFINITIVE
INFLATION
INFLUENCE
INFO
INFORMATION
INGREDIENT
INHABITANT
INHERITANCE
INITIAL
INJECTION
INJURY
INJUSTICE
INK
INNOCENCE
INNOVATION
INPUT
INSECT
INSIDE
INSIGHT
INSPECTOR
INSPIRATION
INSTALLATION
INSTANCE
INSTANT
INSTINCT
INSTITUTE
INSTITUTION
INSTRUCTION
INSTRUCTOR
INSTRUMENT
INSULT
INSURANCE
INTELLIGENCE
INTENTION
INTEREST
INTERFERENCE
INTERIOR
INTERNET
INTERPRETER
INTERROGATION
INTERRUPTION
INTERVAL
INTERVIEW
INTESTINE
INTIMIDATION
INTOLERANCE
INTRANET
INTRODUCTION
INTUITION
INVALID
INVASION
INVENTION
INVERTEBRATE
INVESTIGATION
INVESTIGATOR
INVESTMENT
INVITATION
INVOICE
INVOLVEMENT
IPAD
IPHONE
IPOD
IRIS
IRON
IRONY
IRRITATION
ISLAM
ISLAND
ISLE
ISOLATION
ISSUE
IT	Information technology
ITALIC
ITCH
ITEM
ITSELF
IVY
JACKET
JACKPOT
JAIL
JAM
JANUARY	The first month of the year
JAR
JAVELIN
JAW
JAZZ
JEALOUSY
JEANS
JEEP
JELLY
JELLYFISH
JERK
JERSEY
JET
JEW
JEWEL
JEWELLER
JEWELLERY
JIGSAW
JOB
JOCKEY
JOGGER
JOGGING
JOINT
JOKE
JOURNAL
JOURNALIST
JOURNALISM
JOURNEY
JOY
JUDAISM
JUDGE
JUDGMENT
JUDO
JUG
JUGGLER
JUGGLING
JUICE
JULY	The 7th month of the year
JUMP
JUMPER
JUNE	The 6th month of the year
JUNGLE
JUNK
JURY
JUSTICE
KANGAROO
KARATE
KB
KENNEL
KERB
KETCHUP
KETTLE
KEY
KEYBOARD
KEYHOLE
KEYWORD
KG
KGB
KHZ
KICK
KID
KIDNAPPER
KIDNAPPING
KIDNEY
KILLER
KILO
KILOBYTE
KILOGRAM
KILOHERTZ
KILOMETRE
KILOWATT
KIND
KING
KINGDOM
KIOSK
KISS
KIT
KITCHEN
KITTEN
KIWI
KM
KNEE
KNICKERS
KNIFE
KNIGHT
KNITTING
KNIVES
KNOB
KNOCK
KNOCKING
KNOWLEDGE
KNUCKLE
KORAN
KPH
KW
LAB
LABEL
LABORATORY
LABOUR
LACE
LACK
LAD
LADDER
LADIES
LADLE
LADY
LADYBUG
LAKE
LAMP
LAND
LANDFORM
LANDING
LANDLADY
LANDLORD
LANDMARK
LANDSCAPE
LANE
LANGUAGE
LANTERN
LAP
LAPEL
LAPTOP
LASER
LATCH
LATITUDE
LATTER
LAUGH
LAUGHTER
LAUNDERETTE
LAUNDRY
LAVA
LAW
LAWN
LAWNMOWER
LAWSUIT
LAWYER
LAYER
LAYOUT
LAZINESS
LEAD
LEADER
LEADERSHIP
LEAF
LEAFLET
LEAGUE
LEAK
LEAP
LEARNER
LEATHER
LEAVE
LEAVES
LECTURE
LECTURER
LEDGE
LEEK
LEFT
LEFTOVERS
LEG
LEGEND
LEISURE
LEMON
LENGTH
LENS
LENTIL
LEOPARD
LEOTARD
LESBIAN
LESSON
LETTER
LETTERING
LETTUCE
LEVEL
LEVER
LIAR
LIBERTY
LIBRARIAN	A person who works in a library
LIBRARY
LICE
LICENSE
LICORICE
LID
LIE
LIEUTENANT
LIFE
LIFEBELT
LIFEBOAT
LIFEGUARD
LIFESTYLE
LIFETIME
LIFT
LIGHT
LIGHTER
LIGHTHOUSE
LIGHTING
LIGNTNING
LIKELIHOOD
LIKING
LILAC
LILY	A plant with large sweet-smelling
LIMB
LIME
LIMIT
LIMOUSINE
LINE
LINEN
LINER
LINGERIE
LINING
LINK
LION
LIP
LIPSTICK
LIQUID
LIST
LISTENER
LITERACY
LITERATURE
LITRE
LITTER
LIVER
LIVING
LIZARD
LOAD
LOAF
LOAN
LOAVES
LOBBY
LOBSTER
LOCATION
LOCK
LOCKER
LOFT
LOG
LOGIC
LOGO
LOL
LOLLIPOP
LONELINESS
LONGITUDE
LOO
LOOK
LOOM
LOOP
LORD
LORRY
LOSER
LOSS
LOT
LOTION
LOTTERY
LOUNGE
LOUSE
LOVE
LOVER
LOWERCASE
LOYALTY
LTD
LUCK
LUGGAGE
LULLABY
LUMP
LUNCH
LUNCHTIME
LUXURY
LYRICS
MACARONI
MACHINE
MACHINERY
MADAM
MAGAZINE
MAGIC
MAGICIAN
MAID
MAIL
MAILBOX
MAINLAND
MAINTENANCE
MAJESTY
MAJOR
MAJORITY
MAKE
MAKER
MAKEUP
MALARIA
MALE
MALL
MAMMAL
MAN
MANAGEMENT
MANAGER
MANE
MANGA
MANGO
MANKIND
MANNER
MANSION
MANTELPIECE
MANUAL
MANUFACTURER
MANUFACTURING
MAP
MARATHON
MARBLE
MARCH	The 3rd month of the year
MARGARINE
MARGIN
MARK
MARKET
MARKETING
MARMALADE
MARRIAGE
MARSH
MARSHMALLOW
MASK
MASS
MASSACRE
MASSAGE
MAST
MASTER
MASTERPIECE
MAT
MATCH
MATE
MATERIAL
MATH
MATHEMATICS
MATINEE
MATTER
MATTRESS
MAXIMUM
MAY	The 5th month of the year
MAYONNAISE
MAYOR
MAZE
ME
MEADOW
MEAL
MEAN
MEANING
MEANS
MEANTIME
MEASLES
MEASURE
MEASUREMENT
MEAT
MECHANIC
MECHANISM
MEDAL
MEDIA
MEDIAN
MEDICATION
MEDICINE
MEDIUM
MEETING
MEGABYTE
MELODY
MELON
MEMBER
MEMBERSHIP
MEMO
MEMORY
MEM
MENSWEAR
MENU
MERCHANDISE
MERCURY
MERCY
MERIT
MERMAID
MESS
MESSAGE
METAL
METAPHOR
METEOR
METER
METHOD
METRE
MG
MIAOW
MICE
MICROBE
MICROCHIP
MICROPHONE
MICROSCOPE
MICROWAVE
MIDDAY
MIDDLE
MIDNIGHT
MIGHT
MIGRAINE
MIGRANT
MIGRATION
MILE
MILEAGE
MILK
MILL
MILLIGRAM
MILLILITRE
MILLIMETRE
MILLION	The number 1000000
MILLIONAIRE
MIME
MINCE
MIND
MINE
MINERAL
MINIMUM
MINISTER
MINISTRY
MINORITY
MINT
MINUTE
MIRACLE
MIRROR
MISBEHAVIOUR
MISCHIEF
MISERY
MISFORTUNE
MISS
MISSILE
MISSION
MIST
MISTAKE
MISUNDERSTANDING
MITTEN
MIXER
MIXTURE
ML
MM
MOAN
MODAL
MODEL
MODESTY
MODIFICATION
MOISTURE
MOLE
MOLECULE
MOM
MOMENT
MONDAY
MONEY
MONK
MONKEY
MONOPOLY
MONSOON
MONSTER
MONTH
MONUMENT
MOOD
MOON
MOONLIGHT
MOOSE
MOP
MORAL
MORNING
MORGAGE
MOSAIC
MOSQUE
MOSQUITO
MOSS
MOTEL
MOTH
MOTHER
MOTHERHOOD
MOTION
MOTIVATION
MOTIVE
MOTOR
MOTERBIKE
MOTORIST
MOTORWAY
MOTTO
MOULD
MOINTAIN
MOINTAINER
MOURNER
MOURNING
MOUSE
MOUSSE
MOUSTACHE
MOUTH
MOVE
MOVEMENT
MOVER
MOVIE
MOZZARELLA
MP
MPH	Miles per hour
MR	Mister
MRS
MS
MUD
MUDDLE
MUFFIN
MUG
MULTIMEDIA
MULTIPLICATION
MULTISTOREY
MUM
MUMMY
MURDER
MUSCLE
MUSEUM
MUSHROOM
MUSIC
MUSICAL
MUSICIAN
MUSLIM
MUSTARD
MYSELF
MISTERY
MYTH
NAIL
NAME
NANNY	A person who takes care of children
NAP
NAPKIN
NAPPY
NARRATOR
NATION
NATIONALITY
NATIVE
NATURE
NAUSEA
NAVIGATION
NAVY
NECESSITY
NECK
NECKLACE
NECTARINE
NEED
NEEDLE
NEGATIVE
NEGLIGENCE
NEGOTIATIONS
NEIGH
NEIGHBOUR
NEIGHBOURHOOD
NEPHEW
NERVE
NERVES
NERVOUSNESS
NEST
NET
NETBALL
NETWORK
NEWCOMER
NEWS
NEWSAGENT
NEWSLETTER
NEWSPAPER
NICKNAME
NIECE
NIGHT
NIGHTCLUB
NIGHTDRESS
NIGHTMARE
NINE	The number 9
NINETEEN	The number 19
NINETY	The number 90
NINTH
NO	Number
NOISE
NONFICTION
NONSENSE
NOODLES
NOON
NORTH
NORTHEAST
NORTHWEST
NOSE
NOSTRIL
NOTE
NOTEBOOK
NOTEPAPER
NOTHING
NOTICE
NOTICEBOARD
NOTIFICATION
NOUGHT	The number 0
NOUN
NOURISHMENT
NOVEL
NOVELIST
NOVELTY
NOVEMBER	The 11th month of the year
NECLEUS
NUDE
NUISANCE
NUMBER
NUMERAL
NUN
NURSE
NURSERY
NUT
NUTRIENT
NYLON
OAK
OAR
OASIS
OATMEAL
OATS
OBEDIENCE
OBJECT
OBJECTION
OBJECTIVE
OBLIGATION
OBLONG
OBOE
OBSESSION
OBSTACLE
OBSTRUCTION
OCCASION
OCCUPANT
OCCUPATION
OCCURRENCE
OCEAN
OCTAVE
OCTOBER	The 10th month of the year
OCTOPUS
ODDS
ODOUR
OFFENCE
OFFER
OFFICE
OFFICER
OFFICIAL
OIL
OINTMENT
OLIVE
OMNIVORE
ONE	The number 1
ONESELF
ONION
ONLOOKER
OPENER
OPENING
OPERA
OPERATION
OPERATOR
OPINION
OPPONENT
OPPORTUNITY
OPPOSITION
OPTICIAN
OPTIMISM
OPTION
ORANGE
ORBIT
ORCHARD
ORCHESTRA
ORDEAL
ORDER
ORGAN
ORGANISM
ORGANIZATION
ORGANIZER
ORIGIN
ORIGINAL
ORNAMENT
ORPHAN
ORPHANAGE
OS
ORSTRICH
OUNCE
OURS
OURSELVES
OUTBOX
OUTBREAK
OUTCOME
OUTFIT
OUTING
OUTLINE
OUTLOOK
OUTPUT
OUTRAGE
OUTSIDE
OUTSKIRTS
OVEN
OVERTIME
OWL
OWNER
OWNERSHIP
OXYGEN
OYSTER
OZ
PACE
PACK
PACKAGE
PACKAGING
PACKET
PAD
PADDING
PADDLE
PADLOCK
PAGE
PAIN
PAINKILLER
PAINT
PAINTBRUSH	A tool for painting
PAINTER
PAINTING
PAIR
PAL
PALACE
PALM
PAMPHLET
PAN
PANCAKE
PANDA
PANE
PANEL
PANIC
PANINI
PANTS
PAPER
PAPERBACK
PAPERBOY
PAPERWORK
PARACHUTE
PARADE
PARADISE
PARAFFIN
PARAGRAPH
PARCEL
PARENT
PARENTHOOD
PARK
PARLIAMENT
PARODY
PARROT
PARSLEY
PART
PARTICIPANT
PARTICIPATION
PARTICIPLE
PARTNER
PARTNERSHIP
PARTTIME
PARTY
PASS
PASSAGE
PASSENGER
PASSION
PASSIVE
PASSPORT
PASSWORD
PAST
PASTA
PASTEL
PASTRY
PATCH
PATH
PATIENCE
PATIENT
PATIO
PATROL
PATTERN
PAVEMENT
PAW
PAYMENT
PC
PDF
PE
PEA
PEACE
PEACH
PEAK
PEANUT
PEAR
PEARL
PEASANT
PEBBLE
PEDAL
PEDESTRIAN
PEEL
PEG
PELVIS
PEN
PENALTY
PENCE
PENCIL
PENGUIN
PENINSULA
PENIS
PENKNIFE
PENNY
PENSION
PENTAGON
PEOPLE
PEPPER
PEPPERMINT
PERCENT
PERCENTAGE
PERCUSSION
PERFECTION
PERFORMANCE
PERFUME
PERIMETER
PERIOD
PERMISSION
PERMIT
PERSON
PERSONALITY
PERSONNEL
PERSPECTIVE
PERSPIRATION
PERSUASION
PESSIMISM
PESSIMIST
PEST
PET
PETAL
PETITION
PETROL
PHARMACIST
PHERMACY
PHASE
PHILOSOPHER
PHILOSOPHY
PHONE
PHOTO
PHOTOCOPIER
PHOTOCOPY
PHOTOGRAPH
PHOTOGRAPHER
PHOTOGRAPHY
PHOTOSYNTHESIS
PHOTOSHOP
PHRASE
PHYSICIST
PHYSICS
PIANIST
PIANO
PICCOLO
PIC
PICKLE
PICNIC
PICTURE
PIE
PIECE
PIG
PIGEON
PIGTAIL
PILE
PILL
PILLAR
PILLOW
PILLOWCASE
PILOT
PIN
PINCH
PINE
PINEAPPLE
PINT
PIONEER
PIP
PIPE
PIRATE
PISTOL
PIT
PITCH
PITY
PIZZA
PLACE
PLAIN
PLAN
PLANE
PLANET
PLANT
PLASMA
PLASTER
PLASTIC
PLATE
PLATEAU
PLATFORM
PLAY
PLAYER
PLAYGROUND
PLAYGROUP
PLAYSTATION
PLAYTIME
PLAYWRIGHT
PLEA
PLEASURE
PLECTRUM
PLENTY
PLIERS
PLOP
PLOT
PLOUGH
PLUG
PLUM
PLUMBER
PLURAL
PM
PNEUMONIA
POCKET
POD
PODCAST
POEM
POET
POETRY
POINT
POISON
POKE
POKER
POLE
POLICE
POLICEMAN
POLICEWOMAN
POLICY
POLISH
POLITENESS
POLITICIAN
POLITICS
POLL
POLLEN
POLLUTION
POLYESTER
POND
PONY
PONYTAIL
POOL
POOR
POP
POPCORN
POPULARITY
POPULATION
PORCH
PORE
PORK
PORRIDGE
PORT
PORTER
PORTION
PORTRAIT
POSE
POSITION
POSSESSION
POSSIBILITY
POST
POSTAGE
POSTBOX
POSTCARD
POSTCODE
POSTER
POSTMAN
POT
POTATO
POTENTIAL
POTTERY
POULTRY
POUND
POVERTY
POWDER
POWER
PRACTICE
PRAISE
PRAM
PRAWN
PRAYER
PRECAUTION
PREDATOR
PREDICTION
PREFACE
PREFERENCE
PREFIX
PREGNANCY
PREJUDICE
PREPARATION
PREPOSITION
PRESCRIPTION
PRESENCE
PRESENT
PRESENTATION
PRESERVATIVE
PRESERVATION
PERSIDENCY
PERSIDENT
PRESS
PRESSURE
PREVENTION
PREY
PRICE
PRIDE
PRIEST
PRINCE
PRINCESS
PRINCIPAL
PRINCIPLE
PRINT
PRINTER
PRINTOUT
PRIORITY
PRISON
PRISONER
PRIVACY
PRIVILEGE
PRIZE
PROBABILITY
PROBLEM
PROCEDURE
PROCESS
PROCESSION
PROCESSOR
PRODUCER
PRODUCT
PRODUCTION
PROFESSION
PROFESSIONAL
PROFESSOR
PROFILE
PROFIT
PROGRAM
PROGRAMMER
PROGRAMMING
PROGRESS
PROJECT
PROJECTOR
PROLOGUE
PROMISE
PROMOTION
PRONOUN
PRONUNCIATION
PROOF
PROPAGANDA
PROPELLER
PROPERTY
PROPORTION
PROPOSAL
PROSE
PROSECUTION
PROTECTION
PROTEIN
PROTESTER
PROTESTANT
PROTRACTOR
PROVERB
PROVINCE
PROVISION
PRUNE
PS
PSYCHIATRIST
PSYCHOLOGY
PSYCHOLOGIST
PUB
PUBLIC
PUBLICATION
PUBLICITY
PUBLISHER
PUDDING
PUDDLE
PUFF
PULL
PULLOVER
PULSE
PUMP
PUMKIN
PUN
PUNCH
PUNCTUATION
PUNCTURE
PUNISHMENT
PUP
PUPIL
PUPPET
PUPPY
PURCHASE
PURPOSE
PURSE
PURSUIT
PUSH
PUSHCHAIR
PUZZLE
PYJAMAS
PYRAMID
PYTHON
QUACK	The sound that a duck makes
QUALIFICATION
QUALITY
QUANTITY
QUARREL
QUARRY
QUATER
QUARTET
QUAY
QUEEN
QUERY
QUESTION
QUESTIONING
QUESTIONAIRE
QUEUE
QUILT
QUIZ
QUOTATION
QUOTE
RABBI
RABBIT
RACE
RACECOURSE
RACING
RACISM
RACIST
RACK
RACKET
RADAR
RADIATION
RADIATOR
RADIO
RADIUS
RAFFLE
RAFT
RAG
RAGE
RAIL
RAILING
RAILWAY
RAIN
RAINBOW
RAINCOAT
RAINDROP
RAINFALL
RAINFOREST
RAISIN	A dried grape
RAKE
RALLY
RAM
RAMP
RANCH
RANGE
RANK
RANSOM
RAP
RASH
RASPBERRY
RAT
RATE
RATIO
RATION
RATTLE
RAY
RAZOR
REACTION
READER
READING
REALITY
REALIZATION
REAR
REASON
REBEL
REBELLION
RECEIPT
RECEIVER
RECEPTION
RECEPTIONIST
RECESSION
RECIPE
RECOGNITION
RECOLLECTION
RECOMMENDATION
RECORD
RECORDER
RECORDING
RECOVERY
RECREATION
RECRUIT
RECTANGLE
RED	The color of blood or a tomato
REDUCTION
READ
REFERENCE
REFEREE
REFLECTION
REFORM
REFRESHMENTS
REFRIGERATOR
REFUGEE
REFUND
REFUSAL
REGARD
REGGAE
REGIMENT
REGION
REGISTER
REGISTRATION
REGRET
REGULATION
REHEARSAL
REIN
REINDEER
REJECTION
REJOICING
RELATION
RELATIONSHIP
RELATIVE
RELAXATION
RELAY
RELEASE
RELIABILITY
RELIEF
RELIGION
REMAINDER
REMAINS
REMARK
REMEDY
REMINDER
REMORSE
REMOVAL
REPAYMENT
REPEAT
REPETITION
REPLACEMENT
REPLAY
REPORT
REPORTER
REPRESENTATIVE
REPRODUCTION
REPTILE
REPUBLIC
REPUTATION
REQUEST
REQUIREMENT
RESCUE
RESEARCH
RESEMBLANCE
RESENTMENT
RESERVATION
RESERVE
RESERVOIR
RESIDENT
RESIGNATION
RESISTANCE
RESOLUTION
RESORT
RESOURCES
RESPECT
RESPIRATION
RESPONSE
RESPONSIBILITY
REST
RESTAURANT
RESTRICTION
RESTROOM
RESULT
RESUME
RETAIL
RETAILER
RETIREMENT
RETURN
REUNION
REVENGE
REVENUE
REVEREND
REVERSE
REVIEW
REVOLT
REVOLUTION
REVOLVER
REWARD
RHINOCEROS
RHYME
RIB
RIBBON
RICE
RIDDLE
RIDE
RIDER
RIDGE
RIGHT
RIM
RIND
RING
RINGTONE
RINK
RIOT
RIPPLE
RISK
RITUAL
RIVAL
RIVER
ROAD
ROBBERY
ROBE
ROBIN
ROBOT
BOT
ROCK
ROCKET
ROD
RODENT
ROLE
ROLL
ROMANCE
ROOF
ROOM
ROOT
ROPE
ROSE
ROUND
ROUNDABOUT
ROUTE
ROUTINE
ROW
ROYALITY
RUBBER
RUBBISH
RUBY
RUCKSACK
RUDENESS
RUG
RUGBY
RUINS
RULE
RULER
RUMBLE
RUMOUR
RUNNING
RUNG
RUNNER
RUNWAY
RUSH
RUST
RUT
SACK
SACRIFICE
SADNESS
SADDLE
SAFARI
SAFE
SAFETY
SAIL
SAILING
SAILOR
SAINT
SAKE
SALAD
SALARY
SALE
SALESMAN
SALESPERSON
SALESWOMAN
SALIVA
SALMON
SALON
SALT
SAMPLE
SAND
SANDAL
SANDWICH
SARCASM
SARDINE
SATELLITE
SATIN
SATIRE
SATISFACTION
SATNAV
SATURDAY
SAUCE
SAUCEPAN
SAUCER
SAUNA
SAUSAGE
SAVE
SAVINGS
SAW
SAXOPHONE
SAYING
SCAB
SCAFFOLDING
SCALE
SCALES
SCALP
SCANDAL
SCANNER
SCAR
SCARE
SCARF
SCENE
SCENERY
SCENT
SCHEDULE
SCHOLAR
SCHOLARSHIP
SCHOOL
SCHOOLTEACHER
SCIENCE
SCIENTIST
SCIFI
SCISSORS
SCOOTER
SCORE
SCORN
SCOUT
SCRAP
SCRATCH
SCREEN
SCREENSAVER
SCREW
SCREWDRIVER
SCRIPT
SCULPTOR
SCULPTURE
SEA
SEAFOOD
SEAGULL
SEAL
SEAM
SEARCH
SEASIDE
SEAT
SEAWEED
SECOND
SECRECY
SECRET
SECRETARY
SECTION
SECURITY
SEED
SEGMENT
SEGREGATION
SELECTION
SELF
SELFIE
SELFISHNESS
SEMESTER
SEMICIRCLE
SEMICOLON
SEMIFINAL
SEMINAR
SENSATION
SENSE
SENTENCE
SEPTEMBER	The 9th month of the year
SEQUENCE
SERGEANT
SERIAL
SERIES
SERIOUSNESS
SERMON
SERVANT
SERVER
SERVICE
SESSION
SET
SETTLEMENT
SEVEN	The number 7
SEVENTEEN	The number 17
SEVENTY	The number 70
SEVERAL
SEWING
SEWER
SEX
SHADE
SHADOW
SHAKE
SHAME
SHAMPOO
SHAPE
SHARE
SHAREHOLDER
SHARK
SHAVER
SHAWL
SHE
SHED
SHEEP
SHEET
SHELF
SHELL
SHELLFISH
SHELTER
SHIELD
SHIFT
SHIN
SHIP
SHIRT
SHOCK
SHOE
SHOELACE
SHOOT
SHOP
SHOPPING
SHORE
SHORTAGE
SHORTS
SHOULDER
SHOUT
SHOVEL
SHOW
SHOWER
SHRIMP
SHRINE
SHRUB
SHUTTER
SHUTTLE
SIBLING
SICKNESS
SIDE
SIDEBAR
SIDEWALK
SIEGE
SIEVE
SIGH
SIGHT
SIGHTSEEING
SIGN
SIGNAL
SIGNATURE
SIGNIFICANCE
SIKH
SILENCE
SILHOUETTE
SILK
SILVER
SIM
SIMILARITY
SIMILE
SIMPLICITY
SIN
SINGER
SINGULAR
SINK
SIP
SIR
SIREN
SISTER
SITE
SITUATION
SIX	The number 6
SIXTEEN	The number 16
SIXTY	The number 60
SIZE
SKATE
SKATEBOARD
SKATEPARK
SKELETON
SKETCH
SKI
SKIER
SKIING
SKILL
SKIN
SKIRT
SKULL
SKY
SKYPE
SKYSCRAPER
SLAB
SLANG
SLASH
SLAUGHTER
SLAVE
SLEDGE
SLEEP
SLEET
SLEEVE
SLICE
SLIDE
SLIME
SLING
SLIP
SLIPPER
SLOGAN
SLOPE
SLOT
SLUG
SLUM
SLUMP
SMARTPHONE
SMELL
SMILE
SMOKE
SMOOTHIE
SMUDGE
SMUGGLER
SNACK
SNAG
SNAIL
SNAKE
SNAP
SNEAKER
SNOB
SNOOKER
SNORKEL
SNOW
SNOWBALL
SNOWBOARD
SNOWBOARDER
SNOWMAN
SOAP
SOCCER
SOCIALISM
SOCIALIST
SOCIETY
SOCK
SOCKET
SODA
SODIUM
SOFA
SOFTWARE
SOIL
SOLDIER
SOLE
SOLICITOR
SOLID
SOLO
SOLUTION
SOME
SOMEBODY
SOMEONE
SOMETHING
SON
SONG
SORROW
SORT
SOUL
SOUND
SOUP
SOURCE
SOUTH
SOUTHEAST
SOUTHWEST
SOUVENIR
SOVERREIGNTY
SOYA
SPA
SPACE
SPACECRAFT
SPACESHIP
SPADE
SPAGHETTI
SPAM
SPAN
SPANNER
SPARK
SPARROW
SPEAKER
SPEAR
SPECIALIST
SPECIALITY
SPECIES
SPECIMEN
SPECK
SPECTACLE
SPECTATOR
SPEECH
SPEED
SPEEDING
SPELL
SPHERE
SPICE
SPIDER
SPINACH
SPINE
SPIRAL
SPIRIT
SPITE
SPLINTER
SPOKE
SPOKESMAN
SPOKESPERSON
SPOKESWOMAN
SPONGE
SPONSOR
SPOON
SPORT
SPOT
SPOTLIGHT
SPOUSE
SPRAY
SPREAD
SPRING
SPRINKLER
SPROUT
SPY
SQUARE
SQUASH
SQUID
SQUIRREL
STABILITY
STABLE
STACK
STADIUM
STAFF
STAG
STAGE
STAIN
STAIR
STAIRCASE
STAIRS
STALK
STAMP
STAND
STANDARD
STANDBY
STAPLER
STAR
STARFISH
STARTER
STATE
STATEMENT
STATIC
STATION
STATIONERY
STATISTIC
STATUE
STATUS
STEAK
STEAM
STEEL
STEM
STEPFATHER
STEPMOTHER
STEREO
STEW
STEWARD
STEWARDESS
STICK
STICKER
STITCH
STOCK
STOCKING
STOMACH
STONE
STOOL
STOP
STORAGE
STORE
STOREY
STORM
STORY
STOVE
STRAIN
STRANGER
STRAP
STRATEGY
STRAW
STRAWBERRY
STREAK
STREET
ST
STRENGTH
STRESS
STRETCH
STRIKE
STRING
STRIP
STRIPE
STROKE
STRUCTURE
STRUGGLE
STUDENT
STUDIES
STUDIO
STUDY
STUFF
STUMP
STUNT
STUPIDITY
STYLE
SUBJECT
SUBMARINE
SUBSCRIPTION
SUBSIDY
SUBSTANCE
SUBURB
SUBWAY
SUCCESS
SUDOKU
SUFFERING
SUFFIX
SUFFRAGIST
SUGAR
SUGGESTION
SUICIDE
SUIT
SUITCASE
SUM
SUMMARY
SUMMER
SUMMIT
SUN
SUNBATHING
SUNBURN
SUNDAE
SUNDAY
SUNFLOWER
SUNGLASSES
SUNLIGHT
SUNRISE
SUNSCREEN
SUNSET
SUNSHINE
SUNTAN
SUPERIOR
SUPERMARKET
SUPERSTITION
SUPERVISOR
SUPPER
SUPPLEMENT
SUPPLIER
SUPPLIES
SUPPORTER
SUPPORT
SURF
SURFER
SURFING
SURFACE
SURFBOARD
SURGEON
SURGERY
SURNAME
SURPLUS
SURPRISE
SURROUNDINGS
SURVEY
SURVIVAL
SURVIVOR
SUSPECT
SUSPENSE
SUSPICION
SUSTAINABILITY
SWALLOW
SWAN
SWEAT
SWEATER
SWEATSHIRT
SWEET
SWEETCORN
SWIMMER
SWIM
SWIMMING
SWIMSUIT
SWING
SWITCH
SWORD
SYLLABLE
SYLLABUS
SYMBOL
SYMPATHY
SYMPHONY
SYMPTOM
SYNAGOGUE
SYNDROME
SYNONYM
SYRINGE
SYRUP
SYSTEM
TWITTER
